[vias]
7,0,22,130,0,27,1,0
125,0,50,4,0,41,1,1
23,0,91,78,0,18,1,2
90,0,5,90,0,100,1,3
112,0,95,112,0,6,1,4

[carros]
0.2


[conversoes]
0,0,2,1
0,2,1,2
0,1,3,2
0,3,0,1
0,0,4,2
0,4,-1,2