[vias]
120,0,10,20,0,10,1,0
123,0,18,25,0,14,1,1
126,0,28,31,0,82,1,2
128,0,36,38,0,91,1,3
131,0,45,40,0,101,1,4
137,0,50,43,0,111,1,5
149,0,70,55,0,125,1,6
170,0,90,75,0,150,1,7
44,0,5,77,0,104,1,8
83,0,0,112,0,80,1,9
60,0,3,89,0,95,1,10
90,0,0,130,0,60,1,11
100,0,06,15,0,78,1,12
120,0,3,50,0,85,1,13
180,0,110,90,0,175,1,14


