[vias]
120,0,10,20,0,67,1,0
123,0,18,25,0,14,1,1
126,0,28,31,0,82,1,2
128,0,36,38,0,91,1,3
131,0,45,40,0,101,1,4
137,0,50,43,0,111,1,5
44,0,5,77,0,104,1,6
83,0,0,112,0,80,1,7



[carros]
0.1


[conversoes]
0,3,6,2
0,6,5,2
0,5,7,1
0,7,-1,1
